###########
#T........#
#.........#
#PPPPPPPPP#
#PPPPPPPPP#
#.........#
#..B......#
#....G....#
###########