###########
#T........#
#.........#
#PPPPPPPPP#
#PPPPPPPPP#
#..########
#M....B...#
#....G....#
###########