###########
#A........#
#.........#
#.........#
#BBBBBBBBB#
#BBBBBBBBB#
#.........#
#....G....#
###########