###########
#T........#
#.......W.#
#....B....#
#.......M.#
#..##.#...#
#..#GP#...#
#..####...#
###########
